NO ./a

F 220,100,0
    1111
  1110001
  10000011
  10000001
  11111111
C 225,30,0
  
SO ./a
WE ./a
     EA ./a

