

    11111111
  11100011001
  1E1D0000001         
  10D01001001
   1111111001
          11
		F 255,192,203
NO			 				./jisoocat.png
	C 225,30,0000

		SO  	./a
WE	 ./a
EA     ./a



