
C 17,11,8
	F 000,000,0000


11111111111111
10000000000001
10000000000001                                                               1111111111111111111111
10000000000001                                                               1000000000000000000001
10001111110001                                                               1000000000000000000001
10001    10001                                                               1111110000000000000011                            
10001    10001                                                               1100000011111101111011
10001    10001                                                               1001111111000001111001
10001    10001                                                               1001110000011111111001
10001    10001                                                               1011110011000001111101
10001    10001                                                               1000000011111100011101
10001    10001                                                               1011111111111111000001
11111    10001                                                               1001111111111111111101
         10001                                                                100111111111111111101
         10001                                                                 10000011111100000001
         10001                                                                  1111001111000111111
11111111111D1111111111111                                                           100111001
1000000000000000000000001                                                            1001001
1000000000000000000000001                                                             10001
1000000000000000000000001                                                              101
1000000000000000000000001                                                              101
1000000000000000000000001                                                              101
1000000000000000000000001                               1111111111111111111111111111111101
1000000000000000000000001                               10000000000000000000000D0000000001
1000000000000000S00000001                               1000000000000000000000011111111111
10000000000000002000000011111111111111111               100000000000000000000001
100000000000000000000000D0000000000000001               100000000000000000000001
11111111111111111111111111111111111111101           1111100000000000000000000001
                                      101           100D000000000000000000000001
                                      101           1011100000000000000000000001
                                      10111111111111101 100000000000000000000201
                                      12000000000000001 100000000000000000000001
                                      11111111111111111 111111111111111111111111
NO			 				./purple_window_edited.png

		SO  	./blue_light_window.png
WE	 	./purple_window.png
EA     ./black_wall.png

