    1111
  1110001
  10000011
  10000001
  11111111
