NO ./a

F 220,100,0
    1111111
  1110001001
  1E1D10111
  10D000001
   1111111
C 225,30,0

SO ./a
WE ./a
     EA ./a


