

  1111111111111111111111111111111
  1110001100000000000000000000001
  1000000000000100000000000000001
  1000100100001010000000000000001
  1000100100000100000000000000001
  1000100100000200020000000000001
  1000100100000000111111110000001
  11D1100100000000100000010000001
  1000100100000000101111010000001
  1000100100000000101001010000001
  1000100100000000101001010000001
  100ND00100000000101010001000001
  1000100100000000101001010000001
  10001001000000001000010100001D1
  11D1100100000000111111010000011
  1000100100000000000001010000001
  1000100100000000000000000000001
  1111111111111111111111111111111
		F 44,12,34
NO			 				./purple_window_edited.png
	C 000,000,0000

		SO  	./blue_light_window.png
WE	 	./purple_window.png
EA     ./black_wall.png

