NO			 				jisoocat.png


		F 220,100,0
    11111111
  11100011001
  1E1D111 11 1         
  10D011111111
   1111111
	C 225,30,0000

		SO  	./a
WE	 ./a
EA     ./a



