NO			 				./a


		F 220,100,0
    1111111
  1110001001
  1E1D111011            
  10D011101111
   1111111
	C 225,30,0000

		SO  	./a
WE	 ./a
EA     ./a



