NO ./a

    1111
  1110001
  10000011
  10000001
  11111111
  
SO ./a
WE ./a
     EA ./a
