

  1111111111111111111111111111111
  1110001100000000000000000000001
  111W000000000000000000000000001
  10D0100100000000000000000000001
  10D0100100000000000000000000001
  10D0100100000000000000000000001
  10D0100100000000000000000000001
  10D0100100000000000000000000001
  10D0100100000000000000000000001
  10D0100100000000000000000000001
  10D0100100000000000000000000001
  10D0100100000000000000000000001
  10D0100100000000000000000000001
  10D0100100000000000000000000001
  10D0100100000000000000000000001
  10D0100100000000000000000000001
  10D0100100000000000000000000001
  1111111111111111111111111111111
		F 255,192,203
NO			 				./jisoocat.png
	C 225,30,0000

		SO  	./a
WE	 ./a
EA     ./a

