NO ./a

F 220,100,0
    1111111111
  1110001
  1E1D1011
  10D000001
   1111111
C 225,30,0

SO ./a
WE ./a
     EA ./a


