

  11111111111
  11100011001
  111D00W0001         
  10D01001001
  11111111111
		F 255,192,203
NO			 				./jisoocat.png
	C 225,30,0000

		SO  	./a
WE	 ./a
EA     ./a



