NO			 				./a


		F 220,100,0
    1111111
  11100011011
  1E1D111 11            
  10D011111111
   1111111
	C 225,30,0000

		SO  	./a
WE	 ./a
EA     ./a



