

  1111111111111111111111111111111
  1110001100000000000000000000001
  1110000000000100000000000000001
  10D010010000101000000D000000001
  10D010010000010000000N000000001
  10D0100100000000000000000000001
  10D0100100000000111111110000001
  10D0100100000000100000010000001
  10D0100100000000101111010000001
  10D0100100000000101001010000001
  10D0100100000000101001010000001
  10D0100100000000101010001000001
  10D0100100000000101001010000001
  10D0100100000000100001010000001
  10D0100100000000111111010000001
  10D0100100000000000001010000001
  10D0100100000000000000000000001
  1111111111111111111111111111111
		F 255,192,203
NO			 				./jisoocat2.png
	C 225,30,0000

		SO  	./doju.png
WE	 	./white.png
EA     ./black.png

